{
  "version": 1,
  "id": "stage01",
  "name": "はじまりの草原",
  "theme": "grass",
  "width": 400,
  "height": 20,
  "tiles": [
    "................................................................................................................................................................................................................................................................................................................................................................................................................",
    "................................................................................................................................................................................................................................................................................................................................................................................................................",
    "................................................................................................................................................................................................................................................................................................................................................................................................................",
    "................................................................................................................................................................................................................................................................................................................................................................................................................",
    "................................................................................................................................................................................................................................................................................................................................................................................................................",
    "................................................................................................................................................................................................................................................................................................................................................................................................................",
    "................................................................................................................................................................................................................................................................................................................................................................................................................",
    "................................................................................................................................................................................................................................................................................................................................................................................................................",
    "................................................................................................................................................................................................................................................................................................................................................................................................................",
    "................................................................................................................................................................................................................................................................................................................................................................................................................",
    "................................................................................................................................................................................................................................................................................................................................................................................................................",
    "................................................................................................................................................................................................................................................................................................................................................................................................................",
    "................................................................................................................................................................................................................................................................................................................................................................................................................",
    "................................................................................................................................................................................................................................................................................................................................................................................................................",
    ".......................................................................................................................................................................................................................................N...........................................................N...N........................................................................................................",
    "..................................................................................N....N............N...N................................................N...N................................................................N....N............................................................................................................................................................................",
    ".......NNNNNNNNNNNN....NNNNNNNNN...........................NNNNNNNNNNN.......................................................................................................................................................................NNNNNNNNNNNNN..........................................................................NNNNNNN....NNNNNNNN.........................................................",
    ".......NNNNNNNNNNNN....NNNNNNNNN...........................NNNNNNNNNNN..............................................NNNNNNNNNN.............NNNNNNNNN.......................................NNNNNNN..............NNNNNNNNN....................NNNNNNNNNNNNN..................................................NNNNNNNNNNNNNN..........NNNNNNN....NNNNNNNN....NNNNNNNNNN....NNNNNNNNNNNNNN.........................",
    "NNNNNNNNNNNNNNNNNNNNNNNNNNNNNNNNNNSSSSSNNNNNNNSSSSSNNNNNNNNNNNNNNNNNNNNNNNNNNNNNNNNNNNNNNNNNNNNNNNNNNNNNNNNNNNNNNNNNNNNNNNNNNNNNNNNNNNNNNNNNNNNNNNNNNNNNNNNNNNNNNNNNNNN......NNNNNNNNNNNNNNNNNNNNNNNNNNNNNNNNNNNNNNNNNNNNNNNNNNNNNNNNNNNNNNNNNNNNNNNNNNNNNNN......NNNNNNNNNNNN......NNNNNNNNNNNNNNNNNNNNNNNNNNNNNNNNNNNNNNNNNNNNNNNNNNNNNNNNNNNNNNNNNNNNNNNNNNNNNNNNNNNNNNNNNNNNNNNNNNNNNNNNNNNNNNNN......NNNNNN",
    "NNNNNNNNNNNNNNNNNNNNNNNNNNNNNNNNNNNNNNNNNNNNNNNNNNNNNNNNNNNNNNNNNNNNNNNNNNNNNNNNNNNNNNNNNNNNNNNNNNNNNNNNNNNNNNNNNNNNNNNNNNNNNNNNNNNNNNNNNNNNNNNNNNNNNNNNNNNNNNNNNNNNNNN......NNNNNNNNNNNNNNNNNNNNNNNNNNNNNNNNNNNNNNNNNNNNNNNNNNNNNNNNNNNNNNNNNNNNNNNNNNNNNNN......NNNNNNNNNNNN......NNNNNNNNNNNNNNNNNNNNNNNNNNNNNNNNNNNNNNNNNNNNNNNNNNNNNNNNNNNNNNNNNNNNNNNNNNNNNNNNNNNNNNNNNNNNNNNNNNNNNNNNNNNNNNNN......NNNNNN"
  ],
  "start": {
    "x": 3,
    "y": 16
  },
  "goal": {
    "x": 396,
    "y": 16
  },
  "checkpoints": [
    {
      "x": 86,
      "y": 16
    },
    {
      "x": 175,
      "y": 16
    },
    {
      "x": 260,
      "y": 16
    },
    {
      "x": 278,
      "y": 16
    },
    {
      "x": 394,
      "y": 16
    }
  ],
  "enemies": [
    {
      "type": "slime",
      "x": 43,
      "y": 16,
      "dir": 1
    },
    {
      "type": "slime",
      "x": 110,
      "y": 16,
      "dir": 1
    },
    {
      "type": "slime",
      "x": 278,
      "y": 16,
      "dir": -1
    },
    {
      "type": "frog",
      "x": 324,
      "y": 14,
      "dir": 1
    }
  ],
  "mana": {
    "initial": 8,
    "max": 55,
    "regenPerSec": 1.3
  },
  "eraseCost": 3,
  "coins": [
    {
      "x": 13,
      "y": 15
    },
    {
      "x": 13,
      "y": 15
    },
    {
      "x": 170,
      "y": 17
    },
    {
      "x": 37,
      "y": 17
    },
    {
      "x": 387,
      "y": 17
    }
  ]
}
