{
  "version": 1,
  "id": "stage02",
  "name": "洞窟の試練",
  "theme": "cave",
  "width": 420,
  "height": 16,
  "tiles": [
    "....................................................................................................................................................................................................................................................................................................................................................................................................................................",
    "....................................................................................................................................................................................................................................................................................................................................................................................................................................",
    "....................................................................................................................................................................................................................................................................................................................................................................................................................................",
    "....................................................................................................................................................................................................................................................................................................................................................................................................................................",
    "....................................................................................................................................................................................................................................................................................................................................................................................................................................",
    "....................................................................................................................................................................................................................................................................................................................................................................................................................................",
    "....................................................................................................................................................................................................................................................................................................................................................................................................................................",
    "....................................................................................................................................................................................................................................................................................................................................................................................................................................",
    "....................................................................................................................................................................................................................................................................................................................................................................................................................................",
    "....................................................................................................................................................................................................................................................................................................................................................................................................................................",
    ".......................................................................N...N...N......................................................N.....N......................................N................N.......................N...N...................................................................................................................................................................N.....N.........................",
    "........N.....N...............................................................................................................................................................N.........................N..............N...............................................................................................N...N........................................................................................................",
    "..........................................................NNNNNNNN................................................................................NNNNNNNNNNNNNN...........................................................................................................NNNNNNNNNNN..........................................NNNNNNNNNNNN............................................NNNNNNN.....................................",
    "..........................................................NNNNNNNN...................NNNNNNNNNNNNN................................................NNNNNNNNNNNNNN............................................................................NNNNNNNNNNNNN....NNNNNNNNNN....NNNNNNNNNNN...............NNNNNNNNNNNNN..............NNNNNNNNNNNN............................NNNNNNNNNNNN....NNNNNNN.....................................",
    "NNNNNNNNNNNNNNNNNNBBBBNNNNNNNN......NNNNNNNNNNNNNNNSSSSSNNNNNNNNNNNNNNNNNNNNNNNNNNNNNNNNNNNNNNNNNNNNNNNNNNNNNNN......NNNNNNNNNNNNNNNNNNNNNNNNNNNNNNNNNNNNNNNNNNNNNNNNNNNNNNNNNNNNNNNNNNNNNNNNNNNNNNNNNNNNNNNNNNNNNNNNNNNNNNNNNNNNNNNNNNNNNNNNNNNNNNNNNNNNNNNNNNNNNNNNNNNNNNNNNNNNNNNNNNNNNNNNNNNNNNNNNNNNNNNNNNNNNNNNNNNNNNNNNNNNNNNNNNNNNNNNNNNNNNN......NNNNNNNNNNNNNNNNNNNNNNNNNNNNNNNNNNNNNNNNNNNNNNNNNNNNNNNNNNNNNN......NNNNNN",
    "NNNNNNNNNNNNNNNNNNNNNNNNNNNNNN......NNNNNNNNNNNNNNNNNNNNNNNNNNNNNNNNNNNNNNNNNNNNNNNNNNNNNNNNNNNNNNNNNNNNNNNNNNN......NNNNNNNNNNNNNNNNNNNNNNNNNNNNNNNNNNNNNNNNNNNNNNNNNNNNNNNNNNNNNNNNNNNNNNNNNNNNNNNNNNNNNNNNNNNNNNNNNNNNNNNNNNNNNNNNNNNNNNNNNNNNNNNNNNNNNNNNNNNNNNNNNNNNNNNNNNNNNNNNNNNNNNNNNNNNNNNNNNNNNNNNNNNNNNNNNNNNNNNNNNNNNNNNNNNNNNNNNNNNNNN......NNNNNNNNNNNNNNNNNNNNNNNNNNNNNNNNNNNNNNNNNNNNNNNNNNNNNNNNNNNNNN......NNNNNN"
  ],
  "start": {
    "x": 3,
    "y": 13
  },
  "goal": {
    "x": 416,
    "y": 13
  },
  "checkpoints": [
    {
      "x": 17,
      "y": 13
    },
    {
      "x": 38,
      "y": 13
    },
    {
      "x": 119,
      "y": 13
    },
    {
      "x": 348,
      "y": 13
    },
    {
      "x": 414,
      "y": 13
    }
  ],
  "enemies": [
    {
      "type": "bird",
      "x": 286,
      "y": 10,
      "dir": -1
    },
    {
      "type": "frog",
      "x": 295,
      "y": 11,
      "dir": 1
    }
  ],
  "mana": {
    "initial": 8,
    "max": 60,
    "regenPerSec": 1.28
  },
  "eraseCost": 3,
  "coins": [
    {
      "x": 13,
      "y": 13
    },
    {
      "x": 62,
      "y": 11
    },
    {
      "x": 33,
      "y": 13
    },
    {
      "x": 20,
      "y": 13
    },
    {
      "x": 407,
      "y": 13
    }
  ]
}
