{
  "version": 1,
  "id": "stage02",
  "name": "洞窟の試練",
  "theme": "cave",
  "width": 150,
  "height": 16,
  "tiles": [
    "......................................................................................................................................................",
    "......................................................................................................................................................",
    "......................................................................................................................................................",
    "......................................................................................................................................................",
    "......................................................................................................................................................",
    "......................................................................................................................................................",
    "......................................................................................................................................................",
    "......................................................................................................................................................",
    "......................................................................................................................................................",
    "......................................................................................................................................................",
    "......................................................................................................................................................",
    "......................................................................................................................................................",
    "......................................................................................................................................................",
    "....................................................................................................SSS...............................................",
    "NNNNNNNNNNNNNNNNNNNNNNNNNNNNNNNNNNNNNNNN.........NNNNNNNNNNNBBBBBNNNNNNNNNNNNNNNFFFFFNNNNNNNNNNNNNNNNNNNNNNNNNNNNNNNNNNNNNNNNNNNNNNNNNNNNNNNNNNNNNNNNN",
    "NNNNNNNNNNNNNNNNNNNNNNNNNNNNNNNNNNNNNNNN.........NNNNNNNNNNNNNNNNNNNNNNNNNNNNNNNNNNNNNNNNNNNNNNNNNNNNNNNNNNNNNNNNNNNNNNNNNNNNNNNNNNNNNNNNNNNNNNNNNNNNN"
  ],
  "start": {
    "x": 2,
    "y": 12
  },
  "goal": {
    "x": 145,
    "y": 12
  },
  "checkpoints": [
    {
      "x": 30,
      "y": 12
    },
    {
      "x": 90,
      "y": 12
    }
  ],
  "enemies": [
    {
      "type": "slime",
      "x": 20,
      "y": 12,
      "dir": -1
    },
    {
      "type": "frog",
      "x": 70,
      "y": 12,
      "dir": 1
    },
    {
      "type": "bird",
      "x": 110,
      "y": 6,
      "dir": -1
    }
  ],
  "mana": {
    "initial": 12,
    "max": 50,
    "regenPerSec": 1
  },
  "eraseCost": 3
}
