{
  "version": 1,
  "id": "stage05",
  "name": "大草原の丘陵",
  "theme": "grass",
  "width": 480,
  "height": 20,
  "tiles": [
    "................................................................................................................................................................................................................................................................................................................................................................................................................................................................................................",
    "................................................................................................................................................................................................................................................................................................................................................................................................................................................................................................",
    "................................................................................................................................................................................................................................................................................................................................................................................................................................................................................................",
    "................................................................................................................................................................................................................................................................................................................................................................................................................................................................................................",
    "................................................................................................................................................................................................................................................................................................................................................................................................................................................................................................",
    "................................................................................................................................................................................................................................................................................................................................................................................................................................................................................................",
    "................................................................................................................................................................................................................................................................................................................................................................................................................................................................................................",
    "................................................................................................................................................................................................................................................................................................................................................................................................................................................................................................",
    "................................................................................................................................................................................................................................................................................................................................................................................................................................................................................................",
    "................................................................................................................................................................................................................................................................................................................................................................................................................................................................................................",
    "................................................................................................................................................................................................................................................................................................................................................................................................................................................................................................",
    "................................................................................................................................................................................................................................................................................................................................................................................................................................................................................................",
    "................................................................................................................................................................................................................................................................................................................................................................................................................................................................................................",
    "................................................................................................................................................................................................................................................................................................................................................................................................................................................................................................",
    "...................................N...N...N..................................................................................................................................................................................................................................N....................................................................N.............................................................................N....N......................N..................................",
    "......................................................N....N...............................................................N....N...N...................................................................................................................................N....................................................................N.................................N...N...............................................................................N............................",
    ".......NNNNNNNNNN.......................................................................................................................................................NNNNNNNNNNNNNN.........................................................................................................................................................................NNNNNNNNNNN......................................................................................................................",
    ".......NNNNNNNNNN................................................NNNNNNNNN..............................................................................................NNNNNNNNNNNNNN....NNNNNNNNN..............................................................................................................................NNNNNNN.......................NNNNNNNNNNN.....................NNNNNNNNNN.......................................................................................",
    "NNNNNNNNNNNNNNNNNNNNNNNNNNNBBBBBNNNNNNNNNNNNNNNBBBBNNNNNNNNNNNNNNNNNNNNNNNNN........NNNNNNNNNNNNNNN........NNNNNNNNNNNNNNNNNNNNNNNNNNNNNNNNNNNNNNNN.......NNNNNNNNNNNNNNNNNNNNNNNNNNNNNNNNNNNNNNNNNNNNNNNNNNFFFFNNNNNNNNNN......NNNNNNNNNNNNNNNN......NNNNNNNNNNNNNNNNNNNNNNNNNNNN.......NNNNNNNNNNNNNNNN.......NNNNNNNNNNNNNNNNNNNNNNNNNNNNNNNNNNNNNNNNNNNNNNNNNNNNNNNNNNNNNNNNNNNNNNNNNNNNNNNNNNNNNNNNNNN.......NNNNNNNNNNNNNNNNNNNNNNNN......NNNNNNNNNNNNNNNNNNNNNNNNNNNNNNNNN.......NNNNNNNN",
    "NNNNNNNNNNNNNNNNNNNNNNNNNNNNNNNNNNNNNNNNNNNNNNNNNNNNNNNNNNNNNNNNNNNNNNNNNNNN........NNNNNNNNNNNNNNN........NNNNNNNNNNNNNNNNNNNNNNNNNNNNNNNNNNNNNNNN.......NNNNNNNNNNNNNNNNNNNNNNNNNNNNNNNNNNNNNNNNNNNNNNNNNNNNNNNNNNNNNNNN......NNNNNNNNNNNNNNNN......NNNNNNNNNNNNNNNNNNNNNNNNNNNN.......NNNNNNNNNNNNNNNN.......NNNNNNNNNNNNNNNNNNNNNNNNNNNNNNNNNNNNNNNNNNNNNNNNNNNNNNNNNNNNNNNNNNNNNNNNNNNNNNNNNNNNNNNNNNN.......NNNNNNNNNNNNNNNNNNNNNNNN......NNNNNNNNNNNNNNNNNNNNNNNNNNNNNNNNN.......NNNNNNNN"
  ],
  "start": {
    "x": 3,
    "y": 16
  },
  "goal": {
    "x": 476,
    "y": 16
  },
  "checkpoints": [
    {
      "x": 40,
      "y": 16
    },
    {
      "x": 86,
      "y": 16
    },
    {
      "x": 109,
      "y": 16
    },
    {
      "x": 156,
      "y": 16
    },
    {
      "x": 226,
      "y": 16
    },
    {
      "x": 248,
      "y": 16
    },
    {
      "x": 283,
      "y": 16
    },
    {
      "x": 306,
      "y": 16
    },
    {
      "x": 404,
      "y": 16
    },
    {
      "x": 434,
      "y": 16
    },
    {
      "x": 473,
      "y": 16
    }
  ],
  "enemies": [
    {
      "type": "frog",
      "x": 194,
      "y": 15,
      "dir": -1
    },
    {
      "type": "slime",
      "x": 284,
      "y": 16,
      "dir": -1
    }
  ],
  "mana": {
    "initial": 9,
    "max": 75,
    "regenPerSec": 1.21
  },
  "eraseCost": 3,
  "coins": [
    {
      "x": 13,
      "y": 15
    },
    {
      "x": 12,
      "y": 15
    },
    {
      "x": 80,
      "y": 17
    },
    {
      "x": 30,
      "y": 17
    },
    {
      "x": 464,
      "y": 17
    }
  ]
}
