{
  "version": 1,
  "id": "stage03",
  "name": "草原の回廊",
  "theme": "grass",
  "width": 440,
  "height": 20,
  "tiles": [
    "........................................................................................................................................................................................................................................................................................................................................................................................................................................................",
    "........................................................................................................................................................................................................................................................................................................................................................................................................................................................",
    "........................................................................................................................................................................................................................................................................................................................................................................................................................................................",
    "........................................................................................................................................................................................................................................................................................................................................................................................................................................................",
    "........................................................................................................................................................................................................................................................................................................................................................................................................................................................",
    "........................................................................................................................................................................................................................................................................................................................................................................................................................................................",
    "........................................................................................................................................................................................................................................................................................................................................................................................................................................................",
    "........................................................................................................................................................................................................................................................................................................................................................................................................................................................",
    "........................................................................................................................................................................................................................................................................................................................................................................................................................................................",
    "........................................................................................................................................................................................................................................................................................................................................................................................................................................................",
    "........................................................................................................................................................................................................................................................................................................................................................................................................................................................",
    "........................................................................................................................................................................................................................................................................................................................................................................................................................................................",
    "........................................................................................................................................................................................................................................................................................................................................................................................................................................................",
    "........................................................................................................................................................................................................................................................................................................................................................................................................................................................",
    "........N...N..........N.................................................N...N.....................................................................................................................N...................................N....N................N............................................................N...N...........N.............................................................................................................",
    "...................N.................................................N.......................................................................................................................N..................................................N................N...................................................N...............N.............................N...N................................................................................",
    "...................................................NNNNNNNNNNNNN..............................................................NNNNNNNN....NNNNNNNNNNN.......................NNNNNNNNNNN...............................................................................................................................................................NNNNNNNN.......................NNNNNNN....NNNNNNNNN...............................................",
    "...................................................NNNNNNNNNNNNN..............................................................NNNNNNNN....NNNNNNNNNNN....NNNNNNNNNN.........NNNNNNNNNNN...............................................................................NNNNNNN..........NNNNNNNNNNNNNN.................................................NNNNNNNN.......................NNNNNNN....NNNNNNNNN............NNNNNNN............................",
    "NNNNNNNNNNNNNNNNNNNNNNNNNNNNNNNNNNNNBBBNNNNNNNNNNNNNNNNNNNNNNNNNNNNNNNNNNNNNNNNNN......NNNNNNNNNNNNNN.......NNNNNNNNNNNNNNNNNNNNNNNNNNNNNNNNNNNNNNNNNNNNNNNNNNNNNNNNNBBBBBNNNNNNNNNNNNNNNNNNNNNNNNNNNNNNNNNNNNNNNN.......NNNNNNNNNNNNNNNNNNNNNNNNNNNNNNNNNNNNNNNNNNNNNNNNNNNNNNNNNNNNNNNNNNNNNNNNNNNNNNNNNNNNNNNNNNNNNNNNNNNNNNNNNNNNNNNNNNNNNNNNNNNNNNNNNNNNNNNNNNNNNNNNNNNNNNNNNNNNNNNNNNNNNNNNNNNNNNNNNNNNNNNNNNNNNNNNNNNNNNNNNNNNNN.......NNNNNNNNNN",
    "NNNNNNNNNNNNNNNNNNNNNNNNNNNNNNNNNNNNNNNNNNNNNNNNNNNNNNNNNNNNNNNNNNNNNNNNNNNNNNNNN......NNNNNNNNNNNNNN.......NNNNNNNNNNNNNNNNNNNNNNNNNNNNNNNNNNNNNNNNNNNNNNNNNNNNNNNNNNNNNNNNNNNNNNNNNNNNNNNNNNNNNNNNNNNNNNNNNNNNNN.......NNNNNNNNNNNNNNNNNNNNNNNNNNNNNNNNNNNNNNNNNNNNNNNNNNNNNNNNNNNNNNNNNNNNNNNNNNNNNNNNNNNNNNNNNNNNNNNNNNNNNNNNNNNNNNNNNNNNNNNNNNNNNNNNNNNNNNNNNNNNNNNNNNNNNNNNNNNNNNNNNNNNNNNNNNNNNNNNNNNNNNNNNNNNNNNNNNNNNNNNNNNNNN.......NNNNNNNNNN"
  ],
  "start": {
    "x": 3,
    "y": 16
  },
  "goal": {
    "x": 436,
    "y": 16
  },
  "checkpoints": [
    {
      "x": 43,
      "y": 16
    },
    {
      "x": 89,
      "y": 16
    },
    {
      "x": 110,
      "y": 16
    },
    {
      "x": 219,
      "y": 16
    },
    {
      "x": 432,
      "y": 16
    }
  ],
  "enemies": [
    {
      "type": "bird",
      "x": 22,
      "y": 15,
      "dir": -1
    },
    {
      "type": "slime",
      "x": 45,
      "y": 16,
      "dir": 1
    },
    {
      "type": "slime",
      "x": 121,
      "y": 16,
      "dir": -1
    },
    {
      "type": "slime",
      "x": 221,
      "y": 16,
      "dir": -1
    },
    {
      "type": "bird",
      "x": 303,
      "y": 14,
      "dir": 1
    }
  ],
  "mana": {
    "initial": 8,
    "max": 65,
    "regenPerSec": 1.26
  },
  "eraseCost": 3,
  "coins": [
    {
      "x": 13,
      "y": 17
    },
    {
      "x": 57,
      "y": 15
    },
    {
      "x": 84,
      "y": 17
    },
    {
      "x": 37,
      "y": 17
    },
    {
      "x": 430,
      "y": 17
    }
  ]
}
