{
  "version": 1,
  "id": "stage07",
  "name": "花咲く難路",
  "theme": "grass",
  "width": 540,
  "height": 20,
  "tiles": [
    "............................................................................................................................................................................................................................................................................................................................................................................................................................................................................................................................................................",
    "............................................................................................................................................................................................................................................................................................................................................................................................................................................................................................................................................................",
    "............................................................................................................................................................................................................................................................................................................................................................................................................................................................................................................................................................",
    "............................................................................................................................................................................................................................................................................................................................................................................................................................................................................................................................................................",
    "............................................................................................................................................................................................................................................................................................................................................................................................................................................................................................................................................................",
    "............................................................................................................................................................................................................................................................................................................................................................................................................................................................................................................................................................",
    "............................................................................................................................................................................................................................................................................................................................................................................................................................................................................................................................................................",
    "............................................................................................................................................................................................................................................................................................................................................................................................................................................................................................................................................................",
    "............................................................................................................................................................................................................................................................................................................................................................................................................................................................................................................................................................",
    "............................................................................................................................................................................................................................................................................................................................................................................................................................................................................................................................................................",
    "............................................................................................................................................................................................................................................................................................................................................................................................................................................................................................................................................................",
    "............................................................................................................................................................................................................................................................................................................................................................................................................................................................................................................................................................",
    "............................................................................................................................................................................................................................................................................................................................................................................................................................................................................................................................................................",
    "............................................................................................................................................................................................................................................................................................................................................................................................................................................................................................................................................................",
    ".....................................................................................................................................................................................N.....................................N...N.....N....N........................................................................N...........N.....................N.........................................N............................................................N...............................................................................................",
    ".................................................................................................................................................................................N............................................................N...............................................................N...........N................................N...........................N...N.......................................................N....N...................................................................................................",
    "...............................NNNNNNNNN..................................................................................................................................................................................................................................................................................................................................................................................................................................NNNNNNNNNNN....................NNNNNNNNN..........................................",
    "...............................NNNNNNNNN................................................................NNNNNNNNNNN.............................................................................................................................................................................NNNNNNNNN............................NNNNNNNNNN.............................................................NNNNNNN....NNNNNNNNN....NNNNNNNNNN............................NNNNNNNNNNN....NNNNNNNNNNNN....NNNNNNNNN....NNNNNNNNNNNN..........................",
    "NNNNN.........NNNNNNNNNNNNNNNNNNNNNNNNNNNNNNNNNNNNNNNFFFF........NNNNNNNNNNNNNN.......NNNNNNNNNNNNFFFFNNNNNNNNNNNNNNN.......NNNNNNNNNNNNN........NNNNNNNNNN.........NNNNNNNNNNNNNNNNNNNN......NNNNNNNNNNNSSSSNNNNNNNNNNNNNNNNNNNNNNNNNNNNNNNNNNNNN.........NNNNNNNNNN.........NNNNNNNNNNNNNNNNNNNNNNNNNNNNNNNNNNNNNNNNNNNNNNNNNNNNNNNNNNNNNNNNNNNNNNNNNNNNNNNNN.......NNNNNNNNNNNNNNNNNNNNNNNNNNNNNNNNNNNNNNNNNNNNNNNNNNNNNNNNNNNNNNNNNNNNNNNNNNNNNNNNNNNNNNNNNNNNNNNNNNNNNNNNNNNNNNNNNNNNNNNNNNNNNNNNNNNNNNNNNNNNNNNNNNNNNNNNNNNNNN......NNNNNNNNNNNNNNNNNN",
    "NNNNN.........NNNNNNNNNNNNNNNNNNNNNNNNNNNNNNNNNNNNNNNNNNN........NNNNNNNNNNNNNN.......NNNNNNNNNNNNNNNNNNNNNNNNNNNNNNN.......NNNNNNNNNNNNN........NNNNNNNNNN.........NNNNNNNNNNNNNNNNNNNN......NNNNNNNNNNNNNNNNNNNNNNNNNNNNNNNNNNNNNNNNNNNNNNNNNNNN.........NNNNNNNNNN.........NNNNNNNNNNNNNNNNNNNNNNNNNNNNNNNNNNNNNNNNNNNNNNNNNNNNNNNNNNNNNNNNNNNNNNNNNNNNNNNNN.......NNNNNNNNNNNNNNNNNNNNNNNNNNNNNNNNNNNNNNNNNNNNNNNNNNNNNNNNNNNNNNNNNNNNNNNNNNNNNNNNNNNNNNNNNNNNNNNNNNNNNNNNNNNNNNNNNNNNNNNNNNNNNNNNNNNNNNNNNNNNNNNNNNNNNNNNNNNNNN......NNNNNNNNNNNNNNNNNN"
  ],
  "start": {
    "x": 3,
    "y": 16
  },
  "goal": {
    "x": 536,
    "y": 16
  },
  "checkpoints": [
    {
      "x": 16,
      "y": 16
    },
    {
      "x": 67,
      "y": 16
    },
    {
      "x": 88,
      "y": 16
    },
    {
      "x": 126,
      "y": 16
    },
    {
      "x": 147,
      "y": 16
    },
    {
      "x": 166,
      "y": 16
    },
    {
      "x": 192,
      "y": 16
    },
    {
      "x": 253,
      "y": 16
    },
    {
      "x": 272,
      "y": 16
    },
    {
      "x": 360,
      "y": 16
    },
    {
      "x": 524,
      "y": 16
    }
  ],
  "enemies": [
    {
      "type": "bird",
      "x": 45,
      "y": 13,
      "dir": 1
    },
    {
      "type": "bird",
      "x": 151,
      "y": 13,
      "dir": -1
    },
    {
      "type": "slime",
      "x": 279,
      "y": 16,
      "dir": 1
    },
    {
      "type": "frog",
      "x": 330,
      "y": 15,
      "dir": 1
    },
    {
      "type": "frog",
      "x": 425,
      "y": 15,
      "dir": 1
    }
  ],
  "mana": {
    "initial": 9,
    "max": 85,
    "regenPerSec": 1.17
  },
  "eraseCost": 3,
  "coins": [
    {
      "x": 14,
      "y": 17
    },
    {
      "x": 35,
      "y": 15
    },
    {
      "x": 9,
      "y": 17
    },
    {
      "x": 55,
      "y": 17
    },
    {
      "x": 527,
      "y": 17
    }
  ]
}
