{
  "version": 1,
  "id": "stage01",
  "name": "はじまりの草原",
  "theme": "grass",
  "width": 200,
  "height": 20,
  "tiles": [
    "........................................................................................................................................................................................................",
    "........................................................................................................................................................................................................",
    "........................................................................................................................................................................................................",
    "........................................................................................................................................................................................................",
    "........................................................................................................................................................................................................",
    "........................................................................................................................................................................................................",
    "........................................................................................................................................................................................................",
    "........................................................................................................................................................................................................",
    "........................................................................................................................................................................................................",
    "........................................................................................................................................................................................................",
    "........................................................................................................................................................................................................",
    "........................................................................................................................................................................................................",
    "........................................................................................................................................................................................................",
    "......................................................................................................................................................NNN...............................................",
    "........................................................................................................................................................................................................",
    "............................................................NNNN........................................................................................................................................",
    "........................................................................................................................................................................................................",
    "........................................................................................................................................................................................................",
    "NNNNNNNNNNNNNNNNNNNNNNNNNNNNNNNNNNNNNNNN........NNNNNNNNNNNNNNNNNNNNNNNNNNNNNNNNNNNNNNNNNNNNNNNNNNNNNNNNNNNNNNNNNNNNNNNNNNNNNNNNNNNNNNNNNNNNNNNNNNNNNNNNNNNNNNNNNNNNNNNNNNNNNNNNNNNNNNNNNNNNNNNNNNNNNNNN",
    "NNNNNNNNNNNNNNNNNNNNNNNNNNNNNNNNNNNNNNNN........NNNNNNNNNNNNNNNNNNNNNNNNNNNNNNNNNNNNNNNNNNNNNNNNNNNNNNNNNNNNNNNNNNNNNNNNNNNNNNNNNNNNNNNNNNNNNNNNNNNNNNNNNNNNNNNNNNNNNNNNNNNNNNNNNNNNNNNNNNNNNNNNNNNNNNNN"
  ],
  "start": {
    "x": 2,
    "y": 16
  },
  "goal": {
    "x": 195,
    "y": 16
  },
  "checkpoints": [
    {
      "x": 20,
      "y": 16
    },
    {
      "x": 150,
      "y": 11
    }
  ],
  "enemies": [
    {
      "type": "slime",
      "x": 15,
      "y": 16,
      "dir": -1
    },
    {
      "type": "frog",
      "x": 110,
      "y": 16,
      "dir": 1
    },
    {
      "type": "bird",
      "x": 170,
      "y": 10,
      "dir": -1
    }
  ],
  "mana": {
    "initial": 10,
    "max": 50,
    "regenPerSec": 1
  },
  "eraseCost": 3
}
